15 15
111111111111111
110002020200011
100211010112001
102110020011201
101120010021101
121002212200121
100002111200001
111011111110111
100002111200001
121002212200121
101120010021101
102110020011201
100211010112001
110002020200011
111111111111111
5
12 2 stupid
3 7 stupid
11 7 smart
2 12 smart
12 12 stupid
6
12 3 boots
4 4 heart
2 11 heart
12 11 portal
3 12 gunpowder
11 12 heart
2 2
