15 15
111111111111111
100222000200001
101210101210101
100222000200001
101210101210101
100222000222001
101010101010101
100000020222001
101210101212101
100200200222001
101212101212101
100220000202001
101212101212101
100200200000001
111111111111111
3
10 3 stupid
5 9 smart
4 13 smart
4
3 2 gunpowder
10 5 boots
10 9 heart
3 12 portal
12 7
