15 15
111111111111111
100000020000001
101010121010101
100222222222001
101210121012101
100202222202001
101212101212101
122222000222221
101212101212101
100202222202001
101210121012101
100222222222001
101010121010101
100000020000001
111111111111111
9
5 4 stupid
9 4 stupid
4 5 stupid
10 5 stupid
7 7 smart
4 9 stupid
10 9 stupid
5 10 stupid
9 10 stupid
5
3 3 boots
11 3 gunpowder
9 9 portal
3 11 heart
11 11 heart
1 1
