15 15
111111111111111
100010000002201
100022011111111
100010000200001
111121111112121
122001002100001
121002001111001
121011101021001
101010001011221
102010011021011
100010011011001
100210000021021
101010001111001
121210000002001
111111111111111
8
13 1 smart
10 5 stupid
3 7 smart
9 7 stupid
1 9 smart
12 11 stupid
3 12 smart
13 13 smart
5
12 1 boots
4 4 gunpowder
1 5 heart
10 7 heart
1 13 portal
1 1
