15 15
111111111111111
100002202200221
101012101210121
102222202200001
101212101210101
102222202222221
101010101010101
100000020000001
101010101010101
122222202222221
101012101210101
100002202200001
121012101210121
122002202200221
111111111111111
14
10 1 smart
7 2 smart
10 3 stupid
13 3 smart
11 4 smart
3 10 smart
11 10 smart
1 11 smart
4 11 stupid
10 11 stupid
13 11 smart
7 12 smart
3 13 smart
11 13 smart
3
13 1 gunpowder
1 13 boots
13 13 portal
1 1
